11111111111111111111111111111111111111111111111111111111111111111
1                                                              21
1                                   33333333333333333 33333333321
1                  1         33333  1111 111111111111 11111111121
1                  1                 111                      121
1          4       1                 111 333333333333333333333121
1                  1           2     111 111111111111111111111121
1        33333     1  b        2     11               11111111121
1  b 33    1   33333333        2 3333111111111111111  11111111 21
1333311    1                   2 1111111111111111111  111  111 21
1                              2     111 2      1111  111  111 21
1             2       33       2 3333111 2      1111  111  111 21
1             2       11       2 1111111 2      1111  111  111 21
1     333     2   b            2     111 2   3331111  111      21
1      111   333      33       2 3333111 2      1111  111 2111 21
1            111333   11       2 1111111 2      1111  111 2111 21
1            111111            2     111333   2 1111  111 2111 21
1111                  33       2 3333111      2 1111  111 2111 21
1                     11     1 2 1111111      2 1111      2111 21
1     2 333                    2     111 4    2 1111  111 2111 21
1     2  11 3       3        4 2b    111333   2 111133111 2111331
1     2     1       1 4     333333333111      2 11111111133111111
1  a  2 1  313      1111    111111111111     33311     11111    1
13333 2    111     1111111                  b11111              1
11111111111111111111111111111111111111111111111111111111111111z11
